###########
S #   #   #
# # # # # #
#   #   # #
######### #
# #       #
# # #######
# #   #   #
# # # ### #
#   #     F
###########